SalePrice - цена продажи недвижимости в долларах. Это целевая переменная, которую вы пытаетесь предсказать.
MSSubClass: класс здания
MSZoning: Общая классификация зонирования
LotFrontage: Линейные футы улицы, соединенные с собственностью
LotArea: Размер участка в квадратных футах
Street: Тип подъездной дороги
Alley: Тип доступа к аллее
LotShape: Общая форма свойства
LandContour: Плоскостность участка
Utilities: Тип доступных утилит
LotConfig: Конфигурация лота
LandSlope: Уклон участка
Neighborhood: Физические местоположения в черте города Эймс
Condition1: Близость к главной дороге или железной дороге
Condition2: Близость к главной дороге или железной дороге (если присутствует второй)
BldgType: Тип жилья
HouseStyle: Стиль жилища
OverallQual: Общее качество материала и отделки
OverallCond: Оценка общего состояния
YearBuilt: Дата постройки
YearRemodAdd: Дата переделки
RoofStyle: Тип крыши
RoofMatl: Кровельный материал
Exterior1st: Наружное покрытие на доме
Exterior2nd: Наружное покрытие на дом (если более одного материала)
MasVnrType: Тип кирпичной кладки
MasVnrArea: Площадь кладки шпоном в квадратных футах
ExterQual: Качество материалов для наружных работ
ExterCond: Текущее состояние материала снаружи
Foundation: Тип фундамента
BsmtQual: Высота подвала
BsmtCond: Общее состояние подвала
BsmtExposure: Стены подвала на уровне выбега или на уровне сада
BsmtFinType1: Качество отделанной площади подвала
BsmtFinSF1: Тип 1 отделанные квадратные футы
BsmtFinType2: Качество второго обработанного участка (если присутствует)
BsmtFinSF2: Тип 2 отделанные квадратные футы
BsmtUnfSF: Незаконченные квадратные футы подвальной площади
TotalBsmtSF: Общая площадь подвала
Heating: Тип отопления
HeatingQC: Качество и состояние нагрева
CentralAir: Центральное кондиционирование воздуха
Electrical: Электрическая система
1stFlrSF: Первый этаж квадратные футы
2ndFlrSF: Второй этаж квадратного фута
LowQualFinSF: Низкое качество отделки квадратных футов (все этажи)
GrLivArea: Надземная жилая площадь в квадратных футах
BsmtFullBath: Ремонт ванной комнаты с ванной
BsmtHalfBath: Ремонт ванной комнаты с душем
FullBath: Ванная комната с ванной
HalfBath: Ванная комната с душем
Bedroom: Количество спален над уровнем подвала
Kitchen: Количество кухонь
KitchenQual: Качество кухни
TotRmsAbvGrd: Общее количество номеров выше уровня (включая ванные комнаты)
Functional: Рейтинг функциональности дома
Fireplaces: Количество каминов
FireplaceQu: Качество камина
GarageType: Расположение гаража
GarageYrBlt: Год постройки гаража
GarageFinish: Внутренняя отделка гаража
GarageCars: Размер гаража в автомобильной вместимости
GarageArea: Размер гаража в квадратных футах
GarageQual: Качество гаража
GarageCond: Состояние гаража
PavedDrive: Асфальтированная подъездная дорога
WoodDeckSF: Площадь деревянного настила в квадратных футах
OpenPorchSF: Открытая веранда в квадратных футах
EnclosedPorch: Закрытая площадь крыльца в квадратных футах
3SsnPorch: Трехсезонная веранда в квадратных футах
ScreenPorch: Площадь крыльца в квадратных футах
PoolArea: Площадь бассейна в квадратных футах
PoolQC: Состояние бассейна
Fence: Качество забора
MiscFeature: Прочие функции, не охваченные другими категориями
MiscVal: $Value of miscellaneous feature
MoSold: Месяц продажи
YrSold: Год продажи
SaleType: Тип продажи
SaleCondition: Условия продажи